#################################################################################################################################################################
#S    #           #         #   #   #     #   #   #       #     #   #     #     #   #     #             #   # #     #   #   #     #   #   #   #     #   #       #
##### # ### # ### ### ##### # # ### # ### ### # # # ##### ### # # # # ### # ### # # # ### # ########### # # # # ### # # ### ##### # # # ### # ##### # # # ##### #
#     # #   # #   #   #   #   #     #   #   #   # #   # # #   # # #   # #   #   # #   #   # #   #     # # # # #   #   #   #     # # #   #   #     #   # #   # # #
# ##### ####### ### ### # ### # ########### ### # ### # # # ### # # ### ##### ### ##### ### ### # ### # # # # ### ####### ### ### # ##### ####### # ### ### # # #
#   #   #     #     #   #   # #   # #   # #   # # #     # # #   # #     #     #       # #     # #   # # # #   # #     #   #       #   #   #   #   # #   # # #   #
# ### ### ### ### ######### ##### # # # # ### ### ####### # # ### ### ### ##### ### # # ##### # ### # # # # ### ### # # ### # ##### # # ##### # ### # ### # #####
#   #   # #       #   #   #       #   # #   #   #     #   # #   # #     #   #   #   # #       #     # # # #       # # # #   # #   # #   #   # # #   #       #   #
### ### # # # ##### # # ############# # # ### # # ### # ### ##### ######### # ### ############# ##### # ##### ### ### # # ### # # ####### # # # ### ######### # #
#   # # # # #   #   # #       #     # #     # # # # #   #   #     #     #   # #   #           #     # # #   #   #   # # #   # # # #   #   #   #   # #   #     # #
# ### # ### # ### ### ####### # ### ####### ### # # ##### ##### ### ### # ### # ############# # # # # ### # ### ### # # # ### # ### # ### ### ### # # # # ##### #
# #   #   # #   #   #       # #   # #     # #   # #           #   # # # #     # #           # # # # #   # #   #   # # # # #   # #   #   #   #   # # # #     #   #
# # ##### ##### # # ####### # ### ### ### # # ### ####### ### ### # # # ####### # # # # ##### ### # ### # ### ##### # # ### ### # ##### ####### # # ######### ###
#   #     #     # #     #       #   # #   #   # # #   # #   #   # #   #       # # # # #     # #   # #   # # #   #   # # #   #   # #   #       #     #   #   # # #
# ### ##### ############# ##### ### # # ### ### # # # # ### ### # ####### ### # ### ####### # # ### # ### # ### # ### # # ### ### # # ##### # ### ### # # # # # #
#   # #   #     #       # #   #     # # #   #     # #     #   # # #     # #   # #   #   #   #     # #   # #   #   #   # #   #   #   #     # # #   #   # # #   # #
### # # ### ##### ##### # # # ####### # # ##### # ##### ##### # # # ### # # # # # ### # ### ### # ### # # # # # ### ### ### ### # ######### ### # # ### # # ### #
#   # # #   #     # #   # # # #   #   #   #     # #     #   # #   #   # # # #   # #   #       # #   # # # # # # #   #   #     #   #     #     # # #   #   # #   #
# ### # # ### # # # # ### ### # # # ##### # ##### # ##### # # ####### # ### ##### # ######### # ### ### # # ### # # # ### ######### ### # # # ### ### ##### # # #
#     #   #   # # #   #     #   # #   # #   #     #   #   #   #   #   #     #     #     #   # #   #   # # #   #   # #     #   #   #   # # # #     #   #       # #
### ############# # ### # # ##### ### # ############# ####### # # # ######### ######### # # ######### # # ### ######### ##### # # ### ### # # ##### ########### #
# # #         #   # #   # #   #   # # #   #     #   #     # # # # # #     #   #         # # #     #   # # #   #   #   # #     # #   # #   # # #   # #   #   #   #
# # # ####### # ### # ### ### # ### # ### # ### # # ##### # # # # # # ### # ### ######### # # ### ##### # # ##### # # # # ######### # # ### ### # # ### # # # # #
#   # #   # # # #   # #   #   # #   #   # # # #   #     # # #   # #   #   # #   #       # #   #           # #   # # # # #   #       #   #       # #   #   # # # #
### # # # # # # # ### # ##### # ### # ### # # ##### ### # # ##### ##### ### # ### ##### # ################# # # # # # ##### ####### # ######### # ### # ### ### #
# #     #   # # #   # #     # #   #       # # #     #   # #     #     #   # #   # #   # #     #     #   #   # #   # #             # # #       # # #   # # #   # #
# ### ### ### # ### # ##### # ### ### ##### # # ######### # ### # ####### # ### # ### # ##### # ### ### # ### # ### ####### ##### # ### ##### ### ##### # ### # #
# #     #   #   # #   #     #     #   #     #         #   #   # #     #   # #   #   #   #   # #   #   # # #   #     #         #   #     #   #   #     # #   # # #
# # # # ######### ##### ####### ### ### ####### # ### # ##### ####### # ### # ##### ##### # # ### ### # # # ############### ### ########### ### ##### # ### # # #
# # # #     #   #     # #     #   #   #   #     # # #           #     #     #     #     # # #     #   #   # #   #   #       #   #             # #   #   #   # # #
# # ####### # ### ### # # ### ### # # ### # ##### # ### ####### # ############### ##### # ####### # ### ##### # # # # ####### ##### ####### # # # # ### # # # # #
#   #     # #   #   #   # #   # #   #     # #     #     #       # #     #   #     #     #   #   # # # #       # # # #   #     #   #   #     # #   #   #   # #   #
##### ### # ### ### ####### ### ########### # ########### # ##### # ### # ### ### # ####### # # ### # ####### # # ##### # ##### # ### ####### ####### ##### #####
#       # #   #     #   #   # #         #   #   #         # #   # # #   #     #   #   #   #   #   # #       # # #     # #   # # #       #     # #         #   # #
####### ### # ##### # # # ### ######### # ### ### ### ##### # # # # # ##### # # ### # ### ### ### # ##### ### # ### ### ### # # ##### # # ##### # ### ### ### # #
#       #   # #     # #   #       #   # # # # #   # # # #   # #   # #   #   # #   # #   # #   #   #     #   # # #     # #   #   #     # #   #   # #   #     # # #
# ### ### ### # ##### ##### ##### # # # # # # # ### # # # ### ##### ### ##### ### ##### # ##### ##### # ### ### # ### # # ####### ##### ### # ### # ####### # # #
#   #     #   #   #   #     #   # # # #   # # #   #   # #     #   # # #     #   #       #   # #       #   # #   # # # # # #           # #   #     # #           #
### ####### # ### # ######### ### # ####### # ### ##### ####### # # # ##### ### ##### ### # # ########### # # ### # # # # # # ### ##### ########### # ##### #####
#   #   # # # # # # #   #   #   # #       #   #   #     #   #   #   #   #   # # #   #   # # # # #   #   # # # # #   #   #   # #     #   #     #     #   #       #
# ### # # # # # # # # # ### ### # ####### # ### # # # # # # # ### ##### # # # # # # ### # # # # # # # # # # # # ### ######### ##### # ### ### # ####### # ##### #
# #   # #   # # #   # #   #   # # #   # #   #   # # # #   # #   #     # # # # # # # #   # # #   # #   #   # #   #     #     #     # #     # # #   #   # # #     #
# # ### ##### # ##### ### # # # # # # # ##### ##### ########### ##### # # # # # ### # ##### # ### ######### # ####### # ######### ##### ### # ### # # # # # #####
# # # # #     # #   # #   # #   # # #   #   #     #             #   #   # # # #   # # #   # #   # # #   # # #     #   #   #   #   #         #     # #   # # #   #
# # # # # ##### # # # # ### # ### ### # # # ##### ############### # ##### # # ### # # # # # # ### # # # # # ##### # ### ### # ##### ### ########### ##### # # # #
#   # # #       # # # # #   #   #   # # # #   #   #     #     #   #   #   #     #   # # # #   #     # #   # #     #     #   #         #     #   #   # #   #   # #
##### # ##### ### # ### # ##### ### ### # ##### ### ### ##### # ##### ######### # ### # # # # # ##### ### # # # ### ##### ### ##### # ##### ### # ### # ####### #
# #     #   #     #   #   #   #     #   #       #   #   #   # # #   #     #     #   #   # # #   #     #   # # # #   #     #   #   # # #   #     #     # #   #   #
# # ##### # ####### # # ### # ####### ########### ### ### # # # # ####### # ### ### # ### # ##### ##### ### # # # ### ##### ### # ### # ############# # ### # ###
#   #   # #       # # #   # # #       #     #     # #     #   #   #       #   #     #   #   #   # #   #     # # # #   #   #   # # #   #             # # #   #   #
##### # # ####### ### ### ### # ####### # ### ##### ############### ######### ######### # ### # # # # ####### # # # # # ##### # ### ############### ### # ### # #
#   # # # # #           # #     #       #   # #   # #             #   #   # # #   #   # # #   #   # # #       # # # # # #     # #   #     #       #     #     # #
# # # # # # # ######### # # # ### ######### # # # # # ######### # # ### # # # # # ### # # # ### ### ### ######### # ### # ##### # ####### # ### ############### #
# #   #   #   #       # #   # #   #   #     # # #   #     #   # # # #   #   #   #   #   # #   #     #   #   #     #   #   #   # # # #     #   #           #   # #
# ############# ##### # ##### # ### # # ##### # ######### # # # # # # ##### ####### ######### ##### # ### # # ##### # ##### # # # # # ####### ########### # # # #
#     #   #   # #     #     # # #   #   #     # #     #     # # #     #   #   #   # #     # #   #   #     # # #     # #     # #   #   # #     #   #         #   #
##### # # # ### # # ######### # # ####### ##### # ### ######### ### ### # # # # # # # ### # ### ##### ##### # # ####### ##### ##### ### # ####### # ##### #######
#   #   #       # # #       #   # #     # #     #   #         #   # #   # # # # #     #   #     #     #   #   # #   #   #     #       #     #     #     #   #   #
# # ############# # # ### # # ### # ### # ##### ### ######### ### # ### # # ### ### ### ##### ### ####### ##### # # # ### ### # ##### ### # # ######### ### # # #
# # #       #     #   #   #   # # #   # #           # #     #     # #   # #     # # #   #   # #   # #     #   #   # # #   # #   #     #   #   #         #   # # #
# ### ##### ##### ##### ####### # ### ############### # ### ####### # ### ####### # # # # # # # # # # ##### # ##### # ##### # ### ##### ####### ##### ### ### # #
#     #   #     # #     #   #   #   #   #     #       # # # # #       #   # #   #   # # # #   # # # # #     # #   #   #   #   #   # #   #   # # #   #   # #   # #
####### # ##### ### ##### # # ##### ### ##### # ####### # # # # # # ### # # # # ####### # # ### # # # # ### # # ##### # # ##### ### # ##### # # ### ### # ##### #
#       #         #     # # # #   #   #     # #       # # # #   # # #   # #   #     #   # # #   #   #   #   # #     #   #   #   #   #   #   # #     #   #       #
# ############### ##### # # # # # ### ### # # # ####### # # ####### # ########### # # ### # # ############### ### ######### # ### ### # # # # ####### ######### #
#   #       #   #       # #     #         # # #           #         #           # # #     #   #       #     #   #   #   #   #   # #   #   # #   #     #     #   #
### # # ##### # ######### ########### ####### ########################### ##### # ############# ##### # ### # ##### # # # ### # # # ########### # ##### ### # ###
#   # # #   # #     # #   #     #     #     #                         #   #     #       #   #   #   #   #   #     # # #   # # # # #         # # #     #   # #   #
# ### # # # # ##### # # ### ### # ##### ### ############### ######### # ############### # ### ### # ### ######### # # ##### # # # ######### # # ######### # ### #
# #   #   # #     # #   #   #   #     # # #     #         # #         #     #     #   # #   #     # # #   #         # #   #   #   # #     # # #         # #   # #
# # ####### ####### ##### ### ####### # # ##### # ### ##### # ####### ##### # ##### # # ### ####### # ### # ### # ### ### ######### # ### # # ######### # ### # #
#   #       #       #   # #   #   #   #       #   # # #   # #       #   #   # #     # #   #   #       # #   #   # #   #   #   # #   # #   #   #     # #   # #   #
# ### ####### ### ##### # # ##### # ############### # # # # ####### ### # ### # ##### ### # # # ### ### ### # ##### ### ### # # # # # # ######### # # ##### ### #
# # #     #     #   #   # # #   #   #           #   #   #     #     # #   #   # #   #   #   #   #   #       #       #   #   # #   #   #         # #   #   # # # #
# # ##### # ######### # # ### # # ### ######### ### ######### ### ### ##### ### # # ############# ### ############### ### ### ### ### ######### # ##### ### # # #
# # #   #         #   # #     #   #   #   #   #   #         #   #   # #     # #   #             #   #   #     #   #   #     # #   # #       # #   #       # # # #
# # ### ####### ### ### ########### ### # ### ### # ####### ### # ### # ##### ### ############# ### ### # # # # ### ######### ##### ### ### # ########### # # # #
# #             #   #   #           # # #     #   #       # #   #     # #   # #       #       #   #   #   # #   #   #   #   #   # #   # #   # #               # #
# ############### ### ### ########### # ####### ######### # # ######### # # # ### ##### ##### ### # # ##### # ### # # # # # ### # ### # # ### # ####### # # ### #
#   #             #   # #       #   #         # # #       #   #       #   # #     #   #   # # #   # # #   # # #   # # #   #   #   # #   # #   # #       # # #   #
### # # ########### ### ####### # # ######### # # # ########### ### # ##### ####### # ### # # # ##### # ### # # ### # ####### ### # ### # ### # # # ##### # # ###
#   # # #       #     # #   #   # #   #   #   #     #           #   #     #     # # # # #   # # #   # #     #   # #   # #     #   #     #   # # # # #     #   # #
# ### # # ##### ##### # # # # ####### # # # # ##### # ########### ######### ### # # # # ### ### ### # ####### ### ##### # ##### ### ####### # # ### ########### #
# #   # # #       #   #   #   #     # # #   #     #   #     # #   #       #   #   # # #   #   #       #       #         # # #   #     #   #   #   #       #     #
# # ##### # ##### # ####### ####### # # ####### ####### ### # # ### ##### ### ##### # ### ### ######### # ##### # ####### # # ### ### # # ####### ####### # # ###
#   #     # #   #   #   # #   #   # # #   #   #       # #   #       #     #         # # #   #           #     # #   #     # # #   #   # # #   #   #     # # #   #
##### # ### # # # ### # # ### # # # # ### # # ####### # # ##### ####### ### ######### # ### ##### ####### # # # ### # ##### # # ### ##### # # # # # ##### # # ###
#     #   #   # #   # # # #   # # #     #   #       #   #     # #     # # # # #     # #   #       #       # #   #   #         # #         # # # # #       # #   #
# ############# ##### # # # ### # ##### ########### ### # ### # ##### # # # # # ### # ### ######### ############# ############# ### ######### ### ### ######### #
#   #   #       #     #   #     #   #   #   #       #   # #   #       #     #   # # #   #   # #   #   #   #   # #   #   # #   #   # #       #   #   #       #   #
### # # # ####### ############### ### ### # # ####### ### ############### ####### # ### ### # # # ##### # # # # ### # # # # # ### # # ##### # # ### # ##### # ###
#   # #   #   # #     #     #   #   #     #   #   #   # #                 # #     #     #       #     # # # #   #     #   # #     # #     # # #     # #     #   #
# ### ####### # ### # # ### # # ### ########### # ##### ########### ####### # ############# ######### # # # ############# # ####### ##### # # ####### ### ##### #
#   #         # #   # #   #   # #   #     #     #   #   #     #   #   #       #     #     # #   # #   # #             #     # #     #   # #   # #   #   #       #
### ####### # # # ### ##### ##### ### ### # ####### # ### ### # ##### # ### ### ### # ### # # # # # ####### ######### ##### # # ##### # # ##### # # ### ##### ###
#   #   #   # # # #   #   #   #   #   #   #   #     #   # #   #     # # #     # #   #   #   # # # # #       #       # #   #   #     # #   #   #   #     #   #   #
### # # ##### # # # ### # ### # ### # # ##### # ##### # ### ####### # # ##### ### # # ####### # # # # ####### ##### # # # ######### # ##### # ##### ####### #####
#   # # #   # # # # #   #     #   # # # #   # # #   # #   # # #   #       #   #   #     #   # #   # # #   #   #   # #   # #   #     #     # #     #       #     #
# ##### # # ### # # # ########### ### # # # # # # # # ### # # # ##### ### # ### ##### # # # # ##### # # # # ### ### ##### # # ####### ##### # ### ####### ##### #
#       # #   # # #       #       #   #   #   #   #   #   # # #   #   #   #     #     #   # # #     # # # #   #   #       # #     #   #     #   #   #   # # #   #
############# # # ### ### ### ##### ##### ############# ### # ### # ### ######### ##### ### # # ##### # # # # ### ######### ##### # ### ####### ### # # # # # ###
#               #   #   #     #     #     #     #   # # #   # # #   #   #       # #   # #   #   #   # # #   # #   #   #     # #   #   # #   #   # # # # # # # # #
# ##### # ##### ####### # ##### ##### ##### ### # # # # # ### # ####### # ##### # # # ### ######### # # ####### ### ### ##### # ##### # # # # ### # # ### # # # #
#     # # #   # #       # #     #     #     # # # #   #   # #           # #   #   # # #   #         # #   #   #   #   #       #   #   # # # #   #     #   #   # #
### ### ### # ### ####### # ### # ##### ##### # # ######### ##### ### ### # # ####### # ####### ##### ### # # ### ### ########### # ### # # ### ### ### ### ### #
#   #   #   #     #   #   # #   # #   #     #         #   #     #   # #   # # #       #         #     #   # # #   #         #   # #     # # #   # # # #       # #
# ### ### ######### # # # # # ### ### ### ####### ##### # ##### ### ### ### # # # ############### ######### # # ### # ##### # ### ####### ### # # # # # ##### # #
#   #   # #         #   #   # # #   # # # #     # #     # #       #   #     #   # #   #         #   #       # # #   # #   # #   # #   # #     # # # # # #   # # #
####### # ################### # ### # # # # ### ### ##### ### # # ### ########### ### # ####### ### # ##### # # # ### ### # ### # # # # ######### # # # # # ### #
#     # #         #           # #       # #   #     #   # #   # # # #     #     #     # #       #     #     #   #   # #   #     # # # #   # #   #   #   # #     #
# ### # ### ##### # ####### ### ######### # # ######### # # ### # # ##### # ### ######### ######### ####### # ####### # ### ##### # # # # # # # ##### ### #######
# #     #   #   # #   #   #         #     # # #     #   #   #   #         #   #         # #   #   # #       #         #       #   # # # # #   # #   #   # #   # #
# ########### ### ### # ####### ### # ####### # ### # ##### # ##### ####### ####### ### # # ### # ### ##################### # # # # # ### ##### # # ### # ### # #
# #   #   #       #   # #     #   #   #       #   #   #   # #   #   #     #   #       #   #   # #     # #         # #       # # #   #   #   #   # #       #   # #
# # # # # ### ######### # ### ### ##### ####### # ##### # ##### # ### ### ### # ### ####### # # # ##### # ##### # # # ######### ### ### ### # ######### ### ### #
#   #   #   # #       #   # #     #   # #   #   # #     #       # #     # #   #   #     #   # # #     #   #   # #   #     #   # #     #       #   #   #   #   # #
######### # # # ##### ##### ##### # ### # ### ### # ############# ####### # ######### # ##### # ##### ##### # # ####### # ### # # ######### ##### # # ### ### # #
# #       #     # #   #   #   #   # #   #       # # #   #         #       #     #   # #       #     # #   # # # #   #   #     # # # #       #   # # #   #     # #
# # ############# # ### # ### ##### # ########### # # # # ######### ########### # # ############### # ### # ### # # # # # ##### # # # ####### # # # ### ####### #
#     #   #   # #   # # # # #   #   #     #     #   # #   #       # #             #               # #   #     # # # # # #   #   # #   #     # #     # # #     # #
### # # # ### # # # # # # # ### # ####### # ### ##### ##### ##### # # ######### # ####### ####### ##### ### # # ### ### ##### ### # ### ### # ####### # # ### # #
#   #   #   # #   # #   # #       #       # # #   #   #   #   #   #     #     # #       #       #     #   # #     #   #       #   #     # # #     #       #   # #
# ### # ### # ####### ### ##### ##### ##### # ### # ### # ### ### ### # # ##### ####### ####### ##### ### # ### # # # # ####### ######### # ##### ######### ### #
# #   #   # # #     #   # #   # #   #       # #   #     #   #   #     # #       #   #     #     #   #     #   # #   #   #     # #   #     #   # #   #   #     # #
# ######### # ##### ##### # # # # # ######### # ######### ##### ####### # ####### # # ##### ##### # ########### ##### ### ### ### # # ##### # # ### # # ##### # #
#   #   #   # #     #     # # #   #   #       # #     #         #       # #       # # #   # # #   #           #   # #   #   #   # # # #   # # #   # # #       # #
### # ### ### # ##### ##### # ####### # ####### # ##### # ####### ####### # ####### # # # # # # ############# ### # ### ### ### # # # # ### # ### # ########### #
#   #     #     #   #   #   #     #   #   #       #     #     #   #   #   # #     # #   # # #   #     #     #     #     #   # # # #   #     # #   #   #   #     #
####### # # # ### # ### # ######### ##### # ######### ####### # ##### # ### # ##### ##### # ##### ### # ### ############# ### # # ########### ### ### # # # #####
#       #   #     #   # #   #         #     #         #     # # #     #   # #       #     #   #   #   #   #             #     #       #           #   # # #     #
# ################# ### ### # ### ### # # ############# ### # # # ####### ### ####### ##### # # ### ################### ##### ### ### # ############# # # ### # #
#         #     #   #   #   #   # #   # #     #     #   #     #   #           #   #   #   # #   #   #       #   #     # #   # #   #   #         #   #   # #   # #
######### # ### # ### # # ##### # ########### # ##### ##### # ################# ### # ### # ######### ### # # # ### ### # # ### ### # # ### ### # # ##### # #####
#   #     # #   #   # #   # #   #             #       #     #   # #   #   #         # #       #   #   #   # # # #     # # #     #   # # #   #   # # #     #     #
# # # ####### ##### # ##### # ########### ### ######### ####### # # # # ### ########### ### # # # # ### # ### # # ### # ######### ### # # ### ### # # ######### #
# # #         #   #   #   # # #     #     #   #   #   #     # # #   #   #   # #         #   #   # # #   # #   # # #   #   #       # #   # # #     # # #         #
# ### ### ##### ####### # # # # ### ####### ### # # # ##### # # ####### # ### # ### ##### ####### # # ##### ### # # ##### # ####### ##### # ### ### # # ##### ###
#     #   #       #     # #   #   #       # #   #   #     # #   #     # #   #   #   # #   #     # # #     # #   # #     # #   #   #   #   # # #   #   #   #   # #
####### ######### # ##### ##### # ####### ### ########### # ##### ### # ### ####### # # # # ##### # ##### # # ### ### ### ### # # # # ##### # ### ####### # ### #
#       #       # #     #   #   # #     #     #     #   #   #   # # # #     # #   #   # # #       # #   #   #   # # #     #   # # # #       #     #       #   # #
# ############# # ##### ##### ### # ### ####### ### # # ##### # # # # ####### # # ##### ##### ##### # # ####### # # ####### ### # # ##### ####### # ### # ### # #
#     #     #   #   #         #   # #   #     # #   # #   #   # # # # #       # # #     #     #   #   #       #   #   #   #     #   #     #     #   #   #   # # #
# ### ##### # ##### ### ####### ##### # # ### # ##### ### # ### # # # # ####### ### ##### ##### # ######### ### ##### # # ########### ##### ### ### # ####### # #
#   #       # #   #   # #   #   #     #   #   #         #   #   #   # #       #   #   #   #   # # #           # #   #   # # #         #   # #   #   #   #     # #
### ##### ### # # # # # # # # ### ######### ########### # ### ####### ####### ### ### # ### # # # # ####### # # # # ##### # # ##### ### # # # ### ### # # ##### #
#   #   #     # # # # #   # # # # #     #   #         # #   # #     #           #     # #   # # #   # #     # # # #     # # # #   #     #   #   #   # # #   #   #
# ### # ####### # ### ##### # # # # # ### ### ####### # ##### # ### ######### # ####### # ### ####### # ##### # # ##### # # # ### ############# ##### ##### # ###
# #   # #       #     #   # # #   # #   # #   #   #     #     #   # #   #     #       # #   #   #     # #     #   #     # #   #   # #           #   #   # #     #
# ##### ##### ######### # ### # ####### # # # # ### ##### ####### ### # ### ######### # ### ### # # ### # ######### # ### # ### # # # ########### # ### # ##### #
# #     #     #     # # #     #         #   # # #   #           # #   # #     #   #   #     #   # # #   #   #   #   #   # #     # #   #   #       #     # # #   #
# # # ### ##### ### # # ####### ############# # # ### ######### # # ### # # # # # # ### ##### ### # # ##### # ### ##### # ####### ##### ### ### ######### # # ###
# # #     #   # # # # #         #           # #   # # #   #       #   # # # # # # #     #     #   #   #   # # #   #   # #     # # #   #     #     #     # # #   #
# # ##### ### # # # # ########### ########### ##### # # # # ######### ### # # # # ####### ####### ### # ### # # ### # ####### # # ### ##### # ##### # ### # ### #
# #     # #   #   # # #     #   #             #     # # # #         #     # #   # #     # #   #   #   #   # #       #     #   #   #   #   # #   #   # #   #   # #
# ### # # # ####### # ### ### # ############### ##### ### ##### ########### ### # # ### # # # # ######### # ############# # # ##### ### # ##### # ### # ##### # #
# # # # # #   #   # #       # # #     #   #   #     #     # #   #   #     #   # #   # # #   # # # #         #       #   #   # #     #   # #     # #     #   #   #
# # # # # # # ### # # ### # ### # # # # # # # ##### ####### # ### # # ### ### # ##### # # ### # # # ##### ######### # ### ### # ##### ### # ##### # # ### # #####
#   # # # # #       # # # # #   # # #   #   #         #   #   #   # #   #     # #   #   # #   # # #   #       #   # #   #   #   #     #     #   # # #   # #   # #
# ### # ### ##### ### # # # # ##### ### ########### ### # ##### # # ### ####### # ##### # ##### # ### # # ### # # # ### ### ##### ##### # ### # # # ### # ### # #
#     #         #     #   #   #       #           #     #       # #     #       #       #       #     # #   #   #       #   #     #     #     #   #   #   #    E#
#################################################################################################################################################################
